tilesetIso.png 7 32 64
10 10
0 0 1 1 2 2 1 0 0 1
0 0 1 1 2 2 1 0 0 1
6 6 0 0 1 1 0 0 1 1
1 1 3 3 4 4 3 3 1 1
2 2 3 3 0 0 3 3 2 2
2 2 3 3 5 5 3 3 2 2
1 1 3 3 4 4 3 3 1 1
1 1 0 0 1 1 0 0 1 1
0 0 1 1 2 2 1 0 0 1
0 0 1 1 2 2 1 0 0 1
--
TileProperties
0 0 0
0 0 0
0 0 0
0 1 0
1 0 0
0 1 0
0 0 1
<changeTile> <hazard> <collectible>